!!!!!!!!!!!!!!!!!!!!!!!!!!!!!!!!!!!!!!!!!!!!!!!!!!!!!!!!!!!!!!!!!!!!!!!!!!!!!!!!!!!!!!!!!!!!!!!!!!!!!!!!!!!!!!!!!!!!!!!!!!!!!!!!!!!!!!!!!!!!!!!!!!!!!!!!!!!!!!!!!!!!!!!!!!!!!!!!!!!!!!!!!!!!!!!!!!!!!!!!!!!!!!!!!!!!!!!!!!!!!!!!!!!!!!!!!!
!...........#######################################......................................................................................................................................................................................!
!.............################################...........................................................................................................................................................................................!
!..............##############################################............................................................................................................................................................................!
!.............####################################.......................................................................................................................................................................................!
!.............#################################..........................................................................................................................................................................................!
!..............################################..........................................................................................................................................................................................!
!.............###################################........................................................................................................................................................................................!
!.............###################################........................................................................................................................................................................................!
!..............###################################.......................................................................................................................................................................................!
!.............####################################.......................................................................................................................................................................................!
!.............####################################.......................................................................................................................................................................................!
!..............##################################........................................................................................................................................................................................!
!...............################################.........................................................................................................................................................................................!
!................##############################..........................................................................................................................................................................................!
!.................############################...........................................................................................................................................................................................!
!...................########################.............................................................................................................................................................................................!
!.....................####################...............................................................................................................................................................................................!
!........................################................................................................................................................................................................................................!
!...........................############.................................................................................................................................................................................................!
!........................................................................................................................................................................................................................................!
!........................................................................................................................................................................................................................................!
!........................................................................................................................................................................................................................................!
!........................................................................................................................................................................................................................................!
!........................................................................................................................................................................................................................................!
!........................................................................................................................................................................................................................................!
!........................................................................................................................................................................................................................................!
!........................................................................................................................................................................................................................................!
!........................................................................................................................................................................................................................................!
!........................................................................................................................................................................................................................................!
!........................................................................................................................................................................................................................................!
!........................................................................................................................................................................................................................................!
!........................................................................................................................................................................................................................................!
!........................................................................................................................................................................................................................................!
!........................................................................................................................................................................................................................................!
!........................................................................................................................................................................................................................................!
!........................................................................................................................................................................................................................................!
!........................................................................................................................................................................................................................................!
!........................................................................................................................................................................................................................................!
!........................................................................................................................................................................................................................................!
!........................................................................................................................................................................................................................................!
!........................................................................................................................................................................................................................................!
!........................................................................................................................................................................................................................................!
!........................................................................................................................................................................................................................................!
!........................................................................................................................................................................................................................................!
!........................................................................................................................................................................................................................................!
!........................................................................................................................................................................................................................................!
!........................................................................................................................................................................................................................................!
!........................................................................................................................................................................................................................................!
!........................................................................................................................................................................................................................................!
!........................................................................................................................................................................................................................................!






