...###..............................$..........
..##.#.####.....!!!............................
.##..###..#.....!.!....!!!!....................
##..!!!#..#....!!!!!!!..!.......####...........
#...@..#..#..!!!!!!!..!!!!...####..............
###.....#.............#######...#.###..........
..#..#....#........#####.......##..............
.##.##.#.##....................#...............
.#......##.....................................
.#.....##......................................
.#######.......................................
...............................................
...............................................
...............................................
...............................................
...............................................
...............................................
...............................................
...............................................
...............................................
...............................................
...............................................
...............................................
...............................................
...............................................
...............................................
...............................................
...............................................
...............................................
...............................................





