!!!!!!!!!!!!!!!!!!!!!!!!!!!!!!!!!!!!!!!!!!!!!!!!!!!!!!!!!!!!!!!!!!!!!!!!!!!!!!!!!!!!!!!!!!!!!!!!!!!!!!!!!!!!!!!!!!!!!!!!!!!!!!!!!!!!!!!!!!!!!!!!!!!!!!!!!!!!!!!!!!!!!!!!!!!!!!!!!!!!!!!!!!!!!!!!!!!!!!!!!!!!!!!!!!!!!!!!!!!!!!!!!!!!!!!!!!
!...........##########%################%###########......................................................................................................................................................................................!
!...@..@@.@...#############%#######%####%#####...........................................................................................................................................................................................!
!...@.@.@@..@@.####%######%###%##############%###############............................................................................................................................................................................!
!.@.@@....@...#########################%##%#######.......................................................................................................................................................................................!
!.............#######%#########%#####%#####%###..........................................................................................................................................................................................!
!@@@...........########################%##%####..........................................................................................................................................................................................!
!.............##########%#####%####%#############........................................................................................................................................................................................!
!.............#####%#######%########%####%#######........................................................................................................................................................................................!
!.....@@.......#########%#######%#################.......................................................................................................................................................................................!
!...@.........##%####%###%##%#########%#####%#%###.......................................................................................................................................................................................!
!.....@..@....#####%###########%%########%##%#####.......................................................................................................................................................................................!
!..@@.....@....##########%####################%##........................................................................................................................................................................................!
!..@@..@...@....###############%######%#####%###.........................................................................................................................................................................................!
!...@.@@@@@@@....#####%#################%######..........................................................................................................................................................................................!
!.@..@@@@@@@@@..@.########%#####%#############...........................................................................................................................................................................................!
!......@@@@.@..@@...#########%########%#####.............................................................................................................................................................................................!
!.......@@@@..........######%####%###%####...............................................................................................................................................................................................!
!........................#####%#######%##................................................................................................................................................................................................!
!...........................############.................................................................................................................................................................................................!
!........................................................................................................................................................................................................................................!
!........................................................................................................................................................................................................................................!
!........................................................................................................................................................................................................................................!
!........................................................................................................................................................................................................................................!
!........................................................................................................................................................................................................................................!
!........................................................................................................................................................................................................................................!
!........................................................................................................................................................................................................................................!
!........................................................................................................................................................................................................................................!
!........................................................................................................................................................................................................................................!
!........................................................................................................................................................................................................................................!
!........................................................................................................................................................................................................................................!
!........................................................................................................................................................................................................................................!
!........................................................................................................................................................................................................................................!
!........................................................................................................................................................................................................................................!
!........................................................................................................................................................................................................................................!
!........................................................................................................................................................................................................................................!
!........................................................................................................................................................................................................................................!
!........................................................................................................................................................................................................................................!
!........................................................................................................................................................................................................................................!
!........................................................................................................................................................................................................................................!
!........................................................................................................................................................................................................................................!
!........................................................................................................................................................................................................................................!
!........................................................................................................................................................................................................................................!
!........................................................................................................................................................................................................................................!
!........................................................................................................................................................................................................................................!
!........................................................................................................................................................................................................................................!
!........................................................................................................................................................................................................................................!
!........................................................................................................................................................................................................................................!
!........................................................................................................................................................................................................................................!
!........................................................................................................................................................................................................................................!
!........................................................................................................................................................................................................................................!





