######..........................$..............
..##.#.####.....!!!............................
.##..###..#.....!.!....!!######################
###############################################
###############################################
###############################################
###############################################
###############################################
###############################################
###############################################
###############################################
###############################################
###############################################
###############################################
###############################################
###############################################
###############################################
###############################################
...............................................
...............................................
...............................................
...............................................
...............................................
...............................................
...............................................
...............................................
...............................................
...............................................
...............................................
...............................................





